G G G G G G G G G G G G G G G G G G G G G G G G S
G G G G G G G G G G G G G G G G G G G G S G G G G
G G G G G G G S S S S G G G G G G G G G S G G G G
G G G G G G G G G G G G G G G G G G G G G G G G G
G G G G G G G G G G G G G G G G G G G G G G G G S
G G G G G G G G G G G G G G G G G G G G S G G G G
G R S S S G G G G G G G G G G G G G G G S G G G G
G R S G G G G G G G G G G G G G G G G G S G G G G
G R S S S G G G G G G G G G G G G G G G S G G G G
G R G G G G G G G G G G G G G G G G G G S G G G G
G R G G G G G G G G G G G G G G G G G G S G G G G
G R G G G G G G G G G G S S S G G G G G S G G G G
G R G G G G G G G G G G S S S G G G G G S G G G G
G R G G G G G G G G G G S S S G G G G G S G G G G
G R G G G G G G G G G G G G G G G G G G S G G G G
G G G G G G G G G G G G G G G G G G G G S G G G G
G G G G G G G G G G G G G G G G G G G G S G G G G
G G G G G G G G G G G G G G G G G G G G S G G G G
G G G G G G G G G G G G G G G G G G G G S G G S G
G G G G G G G G G G G G G G G G G G G G S S S S G